2 20 16
####################
#p     ** *  1 * 2 #
# # ###*# # #*#*#  #
#   * 1# b*** ** 4 #
# ### ### #*# # #* #
#  3 #     x **  * #
# # # # # # # # #  #
#*  *  3   *  * f  #
# #s# # #*# # # #* #
#*   #**  *  1  #  #
# #*# # # # # # #* #
#    2   4  *   * x#
# #*# # # # # # #* #
#    4 ** *  1 * 2 #
####################