####################
#p     ** *  1   2 #
# # # #*# #  *  #  #
#   *     ***  *   #
# # # # #     # #* #
#f         x **  * #
# # # # # # # # #  #
#*  *  b   *  *    #
# # # # #*# # # #* #
#*    **  *        #
# #*# # # # # # #* #
#           *   *  #
# #*# # # # # # #* #
#      ** *  1 * 2 #
####################

