1 20 16
####################
#p     ** *  1 * 2 #
# # # #*# # #*#*#  #
#   * 1   ***  * 4 #
# ### ### #*# # #* #
#  3 #     x **  * #
# # # # # # # # #  #
#*  *  3   *  *    #
# #s# # #*# # # #* #
#*    **  *        #
# #*# # # # # # #* #
#    2      *   *  #
# #*# # # # # # #* #
#      ** *  1 * 2 #
####################
