0 20 16
####################
#p     ** *  1   4 #
# # # #*# #  *  #  #
#   *     ***  *   #
# # # # #     # #* #
#f          x**  * #
# # # # # # # # #  #
#*  *  b   *  *    #
# # # # #*# # # #* #
#*   3**  *        #
# #*# # # # # # #* #
#           *   *  #
# #*# # # # # # #* #
#      ** *  3 * 2 #
####################

